num_deptmt,nom_circo,num_circo,Libellé de la circonscription,Inscrits,Abstentions,Votants,Blancs,Nuls,Exprimes,MACRON,LE PEN,id_circ,id_circo,Voix_Lepen_2017,Score_Lepen_2017,investiture
01,Ain,1,1ère circonscription,85742,20298,65444,4020,1229,60195,32671,27524,01001,01001,22644,39.81,Parti socialiste
01,Ain,2,2ème circonscription,99419,23236,76183,4430,1189,70564,38957,31607,01002,01002,26144,40.02,Ecologistes
01,Ain,3,3ème circonscription,81519,23138,58381,3478,880,54023,33838,20185,01003,01003,15573,30.33,Non attribué
01,Ain,4,4ème circonscription,94396,21870,72526,4082,1324,67120,35212,31908,01004,01004,26187,42.04,Non attribué
01,Ain,5,5ème circonscription,77174,21026,56148,3792,1253,51103,25957,25146,01005,01005,20873,42.26,Non attribué
02,Aisne,1,1ère circonscription,72238,17667,54571,3056,1173,50342,20027,30315,02001,02001,25417,51.97,Non attribué
02,Aisne,2,2ème circonscription,73137,19968,53169,2860,1174,49135,21401,27734,02002,02002,24355,48.92,Non attribué
02,Aisne,3,3ème circonscription,66577,16306,50271,2112,1036,47123,16281,30842,02003,02003,28064,59.84,Parti socialiste
02,Aisne,4,4ème circonscription,78708,22739,55969,2954,1118,51897,21104,30793,02004,02004,27082,52.41,Parti communiste
02,Aisne,5,5ème circonscription,82961,21285,61676,3483,1193,57000,23615,33385,02005,02005,29021,51.94,Non attribué
03,Allier,1,1ère circonscription,89176,21776,67400,5000,2444,59956,31443,28513,03001,03001,21789,36.23,Parti communiste
03,Allier,2,2ème circonscription,80749,20777,59972,4581,2382,53009,27000,26009,03002,03002,19051,35.56,Non attribué
03,Allier,3,3ème circonscription,80029,19753,60276,4226,1609,54441,29202,25239,03003,03003,19367,36.49,Parti socialiste
04,Alpes-de-Haute-Provence,1,1ère circonscription,61687,14903,46784,3798,1390,41596,19262,22334,04001,04001,17817,43.46,Non attribué
04,Alpes-de-Haute-Provence,2,2ème circonscription,66390,17004,49386,3850,1336,44200,22395,21805,04002,04002,17000,39.71,Non attribué
05,Hautes-Alpes,1,1ère circonscription,59505,14361,45144,3636,1215,40293,21467,18826,05001,05001,14341,36.92,Non attribué
05,Hautes-Alpes,2,2ème circonscription,54035,12934,41101,3723,1016,36362,20742,15620,05002,05002,12076,34.72,Non attribué
06,Alpes-Maritimes,1,1ère circonscription,81797,26743,55054,2862,1042,51150,29109,22041,06001,06001,19683,38.05,Non attribué
06,Alpes-Maritimes,2,2ème circonscription,88958,23233,65725,3894,1169,60662,27972,32690,06002,06002,27309,47.45,Non attribué
06,Alpes-Maritimes,3,3ème circonscription,90960,28674,62286,3377,1139,57770,31203,26567,06003,06003,24031,41.67,Non attribué
06,Alpes-Maritimes,4,4ème circonscription,85102,22800,62302,3144,1195,57963,24665,33298,06004,06004,29504,51.81,Parti communiste
06,Alpes-Maritimes,5,5ème circonscription,90671,25700,64971,3122,1321,60528,28600,31928,06005,06005,27681,47.63,Ecologistes
06,Alpes-Maritimes,6,6ème circonscription,79484,19664,59820,3605,450,55765,26277,29488,06006,06006,25388,48.45,Non attribué
06,Alpes-Maritimes,7,7ème circonscription,97000,24644,72356,3999,835,67522,38095,29427,06007,06007,24060,38.45,Non attribué
06,Alpes-Maritimes,8,8ème circonscription,83745,24417,59328,3112,742,55474,27857,27617,06008,06008,23537,44.48,Non attribué
06,Alpes-Maritimes,9,9ème circonscription,80985,21272,59713,3219,714,55780,28209,27571,06009,06009,23351,44.02,Parti socialiste
07,Ardèche,1,1ère circonscription,79105,19986,59119,4799,1873,52447,26233,26214,07001,07001,20686,39.89,Parti socialiste
07,Ardèche,2,2ème circonscription,96225,21992,74233,5472,1793,66968,36404,30564,07002,07002,23611,36.6,Non attribué
07,Ardèche,3,3ème circonscription,80601,20186,60415,5526,2049,52840,27617,25223,07003,07003,18812,36.64,Non attribué
08,Ardennes,1,1ère circonscription,70511,16650,53861,2891,1288,49682,22447,27235,08001,08001,23878,48.88,Ecologistes
08,Ardennes,2,2ème circonscription,60539,17727,42812,2569,1006,39237,16538,22699,08002,08002,19641,48.89,Non attribué
08,Ardennes,3,3ème circonscription,55069,13621,41448,2278,978,38192,16100,22092,08003,08003,19052,50.18,Non attribué
09,Ariège,1,1ère circonscription,57252,14293,42959,4372,1844,36743,19439,17304,09001,09001,12604,34.47,Non attribué
09,Ariège,2,2ème circonscription,61795,15460,46335,4204,1961,40170,19858,20312,09002,09002,15470,39.17,Non attribué
10,Aube,1,1ère circonscription,64392,14935,49457,2671,980,45806,20734,25072,10001,10001,22286,49.76,Ecologistes
10,Aube,2,2ème circonscription,74941,17881,57060,3294,1109,52657,25655,27002,10002,10002,22881,44.87,Non attribué
10,Aube,3,3ème circonscription,66266,18482,47784,2728,1059,43997,22441,21556,10003,10003,19013,43.01,Non attribué
11,Aude,1,1ère circonscription,98308,23678,74630,5037,2355,67238,30048,37190,11001,11001,29191,45.23,Ecologistes
11,Aude,2,2ème circonscription,92283,24683,67600,4650,1844,61106,27113,33993,11002,11002,27055,46.87,Parti socialiste
11,Aude,3,3ème circonscription,89369,20259,69110,5465,2487,61158,28303,32855,11003,11003,25206,41.95,Non attribué
12,Aveyron,1,1ère circonscription,77976,17430,60546,4647,1808,54091,34354,19737,12001,12001,13446,25.05,Ecologistes
12,Aveyron,2,2ème circonscription,69106,15952,53154,4657,2298,46199,26886,19313,12002,12002,12527,26.5,Non attribué
12,Aveyron,3,3ème circonscription,72399,16109,56290,4634,2204,49452,28713,20739,12003,12003,14865,30.19,Non attribué
13,Bouches-du-Rhône,1,1ère circonscription,80890,24893,55997,2857,814,52326,26139,26187,13001,13001,22571,44.55,Parti socialiste
13,Bouches-du-Rhône,2,2ème circonscription,82446,23419,59027,3002,858,55167,35891,19276,13002,13002,15589,29.97,Ecologistes
13,Bouches-du-Rhône,3,3ème circonscription,75318,27384,47934,2392,714,44828,22752,22076,13003,13003,20193,43.56,Non attribué
13,Bouches-du-Rhône,4,4ème circonscription,64346,27171,37175,2476,690,34009,26044,7965,13004,13004,7622,21.35,Non attribué
13,Bouches-du-Rhône,5,5ème circonscription,72852,23970,48882,2937,928,45017,29792,15225,13005,13005,13816,31.25,Non attribué
13,Bouches-du-Rhône,6,6ème circonscription,78042,25648,52394,2597,797,49000,26900,22100,13006,13006,19080,39.4,Parti socialiste
13,Bouches-du-Rhône,7,7ème circonscription,66676,31512,35164,1652,631,32881,19910,12971,13007,13007,13227,35.08,Non attribué
13,Bouches-du-Rhône,8,8ème circonscription,102494,25598,76896,4556,1613,70727,33546,37181,13008,13008,31389,46.72,Non attribué
13,Bouches-du-Rhône,9,9ème circonscription,100587,27114,73473,4492,1485,67496,32377,35119,13009,13009,29015,45.51,Non attribué
13,Bouches-du-Rhône,10,10ème circonscription,108638,24992,83646,4836,1553,77257,35479,41778,13010,13010,34260,47.33,Non attribué
13,Bouches-du-Rhône,11,11ème circonscription,91655,23429,68226,3813,1213,63200,36229,26971,13011,13011,22039,36.79,Ecologistes
13,Bouches-du-Rhône,12,12ème circonscription,94229,24815,69414,3921,902,64591,26295,38296,13012,13012,33742,54.52,Non attribué
13,Bouches-du-Rhône,13,13ème circonscription,94195,27353,66842,4619,1940,60283,24959,35324,13013,13013,30199,50.81,Parti socialiste
13,Bouches-du-Rhône,14,14ème circonscription,98763,24438,74325,4459,1390,68476,41924,26552,13014,13014,21239,32.11,Non attribué
13,Bouches-du-Rhône,15,15ème circonscription,109079,24455,84624,5145,1780,77699,35688,42011,13015,13015,34864,48.45,Non attribué
13,Bouches-du-Rhône,16,16ème circonscription,91369,24515,66854,4176,1747,60931,27204,33727,13016,13016,29611,49.3,Non attribué
14,Calvados,1,1ère circonscription,72004,16346,55658,3640,1261,50757,36903,13854,14001,14001,10261,20.89,Non attribué
14,Calvados,2,2ème circonscription,68046,17325,50721,3101,1582,46038,30254,15784,14002,14002,12343,26.94,Parti socialiste
14,Calvados,3,3ème circonscription,79616,18906,60710,3522,1540,55648,27811,27837,14003,14003,22803,42.32,Non attribué
14,Calvados,4,4ème circonscription,104444,23827,80617,4796,1690,74131,43743,30388,14004,14004,23957,34.76,Parti communiste
14,Calvados,5,5ème circonscription,92354,19561,72793,4341,1549,66903,40557,26346,14005,14005,21125,33.32,Ecologistes
14,Calvados,6,6ème circonscription,95740,20359,75381,4449,1883,69049,39303,29746,14006,14006,23513,35.91,Non attribué
15,Cantal,1,1ère circonscription,62900,13985,48915,3750,1633,43532,25778,17754,15001,15001,12148,28.18,Non attribué
15,Cantal,2,2ème circonscription,52841,11830,41011,2990,1198,36823,19276,17547,15002,15002,11790,32.53,Non attribué
16,Charente,1,1ère circonscription,83201,22704,60497,4625,1702,54170,33807,20363,16001,16001,15629,28.29,Non attribué
16,Charente,2,2ème circonscription,83498,20247,63251,4068,1631,57552,30426,27126,16002,16002,21056,37.05,Non attribué
16,Charente,3,3ème circonscription,90809,21452,69357,4671,2669,62017,31421,30596,16003,16003,23231,37.75,Parti socialiste
17,Charente-Maritime,1,1ère circonscription,109900,29070,80830,5402,1799,73629,52198,21431,17001,17001,15472,22.36,Ecologistes
17,Charente-Maritime,2,2ème circonscription,111616,26219,85397,6123,2083,77191,44590,32601,17002,17002,23763,33.68,Non attribué
17,Charente-Maritime,3,3ème circonscription,84000,20899,63101,4496,1740,56865,29755,27110,17003,17003,20418,37.02,Non attribué
17,Charente-Maritime,4,4ème circonscription,94193,22457,71736,4348,1823,65565,31866,33699,17004,17004,25679,41.83,Non attribué
17,Charente-Maritime,5,5ème circonscription,119220,27377,91843,5666,2248,83929,42750,41179,17005,17005,31522,41.47,Parti socialiste
18,Cher,1,1ère circonscription,71129,18942,52187,4166,902,47119,26458,20661,18001,18001,16812,35.62,Parti socialiste
18,Cher,2,2ème circonscription,68926,19610,49316,3710,1437,44169,23331,20838,18002,18002,16970,38.62,Parti communiste
18,Cher,3,3ème circonscription,84402,21703,62699,4634,1454,56611,27950,28661,18003,18003,23576,41.65,Non attribué
19,Corrèze,1,1ère circonscription,91981,20611,71370,7069,4044,60257,33272,26985,19001,19001,17706,28.54,Non attribué
19,Corrèze,2,2ème circonscription,93050,22240,70810,5631,3033,62146,35000,27146,19002,19002,18249,29.46,Ecologistes
2A,Corse-du-Sud,1,1ère circonscription,52141,20951,31190,1902,1019,28269,11734,16535,2A001,2A001,13828,48.09,Non attribué
2A,Corse-du-Sud,2,2ème circonscription,61763,23788,37975,2172,1317,34486,14426,20060,2A002,2A002,16587,50.57,Non attribué
2B,Haute-Corse,1,1ère circonscription,61277,23183,38094,2446,1069,34579,14862,19717,2B001,2B001,16261,50.28,Non attribué
2B,Haute-Corse,2,2ème circonscription,67828,27186,40642,2837,1296,36509,15089,21420,2B002,2B002,16306,45.41,Non attribué
21,Côte-d'Or,1,1ère circonscription,70013,17640,52373,3651,975,47747,33003,14744,21001,21001,11627,24.37,Non attribué
21,Côte-d'Or,2,2ème circonscription,70985,18206,52779,3660,1057,48062,28373,19689,21002,21002,16138,34.29,Non attribué
21,Côte-d'Or,3,3ème circonscription,72063,18540,53523,3673,1067,48783,28609,20174,21003,21003,16929,34.75,Non attribué
21,Côte-d'Or,4,4ème circonscription,68361,15324,53037,3906,1280,47851,22929,24922,21004,21004,20390,43.26,Non attribué
21,Côte-d'Or,5,5ème circonscription,85499,19935,65564,4341,1252,59971,31634,28337,21005,21005,24037,41.35,Non attribué
22,Côtes-d'Armor,1,1ère circonscription,91485,20708,70777,5216,1888,63673,43620,20053,22001,22001,14065,22.32,Non attribué
22,Côtes-d'Armor,2,2ème circonscription,103130,20409,82721,5659,2195,74867,46146,28721,22002,22002,19842,28.55,Non attribué
22,Côtes-d'Armor,3,3ème circonscription,88722,17429,71293,4612,2050,64631,38386,26245,22003,22003,18481,29.4,Non attribué
22,Côtes-d'Armor,4,4ème circonscription,80863,17829,63034,5116,2536,55382,32056,23326,22004,22004,15597,28.64,Non attribué
22,Côtes-d'Armor,5,5ème circonscription,107560,23829,83731,6336,2294,75101,49648,25453,22005,22005,17569,24.17,Non attribué
23,Creuse,1,1ère circonscription,90958,23481,67477,5915,2856,58706,30553,28153,23001,23001,20428,34.24,Non attribué
24,Dordogne,1,1ère circonscription,77345,18741,58604,4581,2403,51620,27239,24381,24001,24001,17330,34.5,Non attribué
24,Dordogne,2,2ème circonscription,84062,20180,63882,4523,2249,57110,28428,28682,24002,24002,21629,38.92,Non attribué
24,Dordogne,3,3ème circonscription,67108,13944,53164,3975,2438,46751,23519,23232,24003,24003,17059,37.25,Non attribué
24,Dordogne,4,4ème circonscription,89614,19741,69873,5914,3064,60895,32296,28599,24004,24004,19317,32.59,Ecologistes
25,Doubs,1,1ère circonscription,75860,20244,55616,4007,1225,50384,31757,18627,25001,25001,15635,30.91,Non attribué
25,Doubs,2,2ème circonscription,78342,19675,58667,4293,1338,53036,34137,18899,25002,25002,15452,29.11,Ecologistes
25,Doubs,3,3ème circonscription,64426,16861,47565,3093,1168,43304,21816,21488,25003,25003,18727,42.6,Non attribué
25,Doubs,4,4ème circonscription,65390,18987,46403,2730,1331,42342,19945,22397,25004,25004,20138,45.89,Parti communiste
25,Doubs,5,5ème circonscription,84419,19688,64731,3961,1573,59197,34261,24936,25005,25005,19983,35.22,Non attribué
26,Drôme,1,1ère circonscription,77457,21958,55499,3587,1195,50717,31454,19263,26001,26001,15812,31.23,Non attribué
26,Drôme,2,2ème circonscription,95601,25003,70598,4526,1711,64361,32485,31876,26002,26002,26737,42.49,Non attribué
26,Drôme,3,3ème circonscription,110433,25171,85262,7835,2269,75158,43821,31337,26003,26003,25439,34.54,Non attribué
26,Drôme,4,4ème circonscription,98789,24452,74337,5154,1507,67676,35936,31740,26004,26004,26324,40.43,Parti socialiste
27,Eure,1,1ère circonscription,86369,22233,64136,3564,1253,59319,28981,30338,27001,27001,26610,45.44,Non attribué
27,Eure,2,2ème circonscription,78710,18095,60615,3602,1155,55858,27575,28283,27002,27002,24042,44.33,Non attribué
27,Eure,3,3ème circonscription,85497,19007,66490,3795,1280,61415,28274,33141,27003,27003,28310,48.17,Non attribué
27,Eure,4,4ème circonscription,92436,23645,68791,4321,1397,63073,31972,31101,27004,27004,26520,43.84,Parti socialiste
27,Eure,5,5ème circonscription,89261,21838,67423,4013,1240,62170,29948,32222,27005,27005,27935,46.39,Ecologistes
28,Eure-et-Loir,1,1ère circonscription,90786,22902,67884,4255,1381,62248,37179,25069,28001,28001,19988,32.94,Ecologistes
28,Eure-et-Loir,2,2ème circonscription,74897,22375,52522,3168,1109,48245,25252,22993,28002,28002,19895,41.05,Non attribué
28,Eure-et-Loir,3,3ème circonscription,71158,18235,52923,3265,1244,48414,25279,23135,28003,28003,19455,40.76,Non attribué
28,Eure-et-Loir,4,4ème circonscription,67166,16093,51073,2927,1124,47022,22034,24988,28004,28004,21358,46.18,Non attribué
29,Finistère,1,1ère circonscription,91841,19685,72156,5246,1782,65128,46392,18736,29001,29001,12544,19.58,Ecologistes
29,Finistère,2,2ème circonscription,78751,22227,56524,5608,179,50737,35851,14886,29002,29002,10450,20.48,Non attribué
29,Finistère,3,3ème circonscription,92903,20390,72513,5506,1107,65900,44582,21318,29003,29003,14866,23.75,Non attribué
29,Finistère,4,4ème circonscription,83764,18684,65080,5041,1726,58313,39791,18522,29004,29004,12355,21.42,Ecologistes
29,Finistère,5,5ème circonscription,97566,20126,77440,5249,1601,70590,48563,22027,29005,29005,14825,21.96,Parti socialiste
29,Finistère,6,6ème circonscription,91049,20837,70212,5477,2070,62665,39819,22846,29006,29006,15553,25.09,Parti socialiste
29,Finistère,7,7ème circonscription,83090,18596,64494,5166,1938,57390,38566,18824,29007,29007,12390,22.13,Non attribué
29,Finistère,8,8ème circonscription,90854,21429,69425,5559,2120,61746,38832,22914,29008,29008,15907,26.78,Non attribué
30,Gard,1,1ère circonscription,89018,27542,61476,3460,1210,56806,29358,27448,30001,30001,24431,43.23,Non attribué
30,Gard,2,2ème circonscription,94624,22685,71939,4305,1536,66098,28698,37400,30002,30002,30832,50.94,Non attribué
30,Gard,3,3ème circonscription,95194,22439,72755,4518,1654,66583,31839,34744,30003,30003,28920,45.23,Parti communiste
30,Gard,4,4ème circonscription,94025,23836,70189,5283,1784,63122,27655,35467,30004,30004,28498,47.41,Parti socialiste
30,Gard,5,5ème circonscription,98217,25940,72277,6127,2160,63990,31516,32474,30005,30005,26386,42.33,Non attribué
30,Gard,6,6ème circonscription,84196,24402,59794,3726,1340,54728,28599,26129,30006,30006,22058,41.87,Ecologistes
31,Haute-Garonne,1,1ère circonscription,83565,22239,61326,4496,1381,55449,40769,14680,31001,31001,10355,19.5,Non attribué
31,Haute-Garonne,2,2ème circonscription,103456,26610,76846,5830,2056,68960,47217,21743,31002,31002,15979,24.27,Non attribué
31,Haute-Garonne,3,3ème circonscription,79921,18129,61792,4162,1311,56319,41810,14509,31003,31003,10157,19.25,Non attribué
31,Haute-Garonne,4,4ème circonscription,68045,20175,47870,3473,1130,43267,33985,9282,31004,31004,6912,16.32,Non attribué
31,Haute-Garonne,5,5ème circonscription,106191,23614,82577,5792,2209,74576,41422,33154,31005,31005,24327,35.99,Non attribué
31,Haute-Garonne,6,6ème circonscription,114771,24939,89832,6144,2354,81334,52623,28711,31006,31006,21523,27.73,Parti socialiste
31,Haute-Garonne,7,7ème circonscription,105980,25451,80529,5876,2348,72305,39564,32741,31007,31007,24885,36.68,Non attribué
31,Haute-Garonne,8,8ème circonscription,86024,20653,65371,5342,2557,57472,28393,29079,31008,31008,21678,38.68,Parti socialiste
31,Haute-Garonne,9,9ème circonscription,79846,22105,57741,4396,1395,51950,35632,16318,31009,31009,12661,24.66,Ecologistes
31,Haute-Garonne,10,10ème circonscription,102780,19642,83138,6319,2069,74750,48517,26233,31010,31010,18118,26.34,Ecologistes
32,Gers,1,1ère circonscription,73590,15825,57765,5125,2031,50609,28794,21815,32001,32001,15839,31.02,Non attribué
32,Gers,2,2ème circonscription,73678,15168,58510,4542,1972,51996,28321,23675,32002,32002,17585,35.21,Parti socialiste
33,Gironde,1,1ère circonscription,103267,28117,75150,4575,1224,69351,52637,16714,33001,33001,11178,17.45,Ecologistes
33,Gironde,2,2ème circonscription,71745,20289,51456,3136,814,47506,39199,8307,33002,33002,5238,11.95,Ecologistes
33,Gironde,3,3ème circonscription,88576,26035,62541,4877,1417,56247,41395,14852,33003,33003,10054,19.19,Non attribué
33,Gironde,4,4ème circonscription,97790,28783,69007,4862,1754,62391,37716,24675,33004,33004,18816,31.29,Parti socialiste
33,Gironde,5,5ème circonscription,120526,28347,92179,5967,2250,83962,44082,39880,33005,33005,29158,38.27,Non attribué
33,Gironde,6,6ème circonscription,107066,24319,82747,5569,1775,75403,51526,23877,33006,33006,16542,23.07,Parti socialiste
33,Gironde,7,7ème circonscription,79467,20338,59129,4336,1360,53433,38558,14875,33007,33007,10576,19.94,Non attribué
33,Gironde,8,8ème circonscription,119423,27956,91467,5818,1974,83675,48395,35280,33008,33008,24691,33.43,Parti communiste
33,Gironde,9,9ème circonscription,101619,22299,79320,6215,2122,70983,39085,31898,33009,33009,21990,34.02,Non attribué
33,Gironde,10,10ème circonscription,82865,19174,63691,4311,1658,57722,29790,27932,33010,33010,21751,39.59,Ecologistes
33,Gironde,11,11ème circonscription,98478,23833,74645,4922,1872,67851,28560,39291,33011,33011,29996,47.54,Non attribué
33,Gironde,12,12ème circonscription,87729,19354,68375,5257,1759,61359,33828,27531,33012,33012,20271,35.02,Non attribué
34,Hérault,1,1ère circonscription,89378,25270,64108,4257,1208,58643,34004,24639,34001,34001,19786,35.77,Non attribué
34,Hérault,2,2ème circonscription,64919,23223,41696,2837,840,38019,29005,9014,34002,34002,6997,18.92,Non attribué
34,Hérault,3,3ème circonscription,91583,21163,70420,4677,1471,64272,40353,23919,34003,34003,18488,31.78,Ecologistes
34,Hérault,4,4ème circonscription,118703,27599,91104,7045,2306,81753,42802,38951,34004,34004,30684,40.44,Non attribué
34,Hérault,5,5ème circonscription,98585,24298,74287,5785,2229,66273,28067,38206,34005,34005,29549,47.77,Non attribué
34,Hérault,6,6ème circonscription,93296,25239,68057,4087,1414,62556,25824,36732,34006,34006,30602,51.58,Parti communiste
34,Hérault,7,7ème circonscription,108477,28974,79503,4785,2149,72569,31839,40730,34007,34007,33961,50.26,Non attribué
34,Hérault,8,8ème circonscription,93646,25359,68287,4506,1605,62176,33035,29141,34008,34008,23607,40.7,Non attribué
34,Hérault,9,9ème circonscription,88892,24661,64231,3787,1396,59048,32282,26766,34009,34009,21473,39.43,Non attribué
35,Ille-et-Vilaine,1,1ère circonscription,93001,23029,69972,4927,1395,63650,50146,13504,35001,35001,9603,15.46,Non attribué
35,Ille-et-Vilaine,2,2ème circonscription,97514,19908,77606,5080,1500,71026,55927,15099,35002,35002,10161,15.02,Ecologistes
35,Ille-et-Vilaine,3,3ème circonscription,91540,19208,72332,4962,1616,65754,44647,21107,35003,35003,15446,24.98,Parti socialiste
35,Ille-et-Vilaine,4,4ème circonscription,95439,20357,75082,5380,1737,67965,42721,25244,35004,35004,18936,29.56,Non attribué
35,Ille-et-Vilaine,5,5ème circonscription,109362,22204,87158,5049,1845,80264,55352,24912,35005,35005,17750,23.83,Non attribué
35,Ille-et-Vilaine,6,6ème circonscription,89908,18402,71506,4497,1846,65163,41487,23676,35006,35006,18372,29.48,Non attribué
35,Ille-et-Vilaine,7,7ème circonscription,104823,24149,80674,5097,1874,73703,48822,24881,35007,35007,18147,26.53,Non attribué
35,Ille-et-Vilaine,8,8ème circonscription,90283,21772,68511,4497,1277,62737,51230,11507,35008,35008,7527,12.88,Non attribué
36,Indre,1,1ère circonscription,77639,20877,56762,3743,1831,51188,27558,23630,36001,36001,19052,37.18,Non attribué
36,Indre,2,2ème circonscription,88418,20330,68088,4961,2331,60796,30016,30780,36002,36002,24575,40.58,Non attribué
37,Indre-et-Loire,1,1ère circonscription,70575,22292,48283,3338,980,43965,32777,11188,37001,37001,8429,19.37,Ecologistes
37,Indre-et-Loire,2,2ème circonscription,91984,20522,71462,4777,1593,65092,38734,26358,37002,37002,20896,34.16,Non attribué
37,Indre-et-Loire,3,3ème circonscription,99276,23284,75992,5165,1763,69064,42539,26525,37003,37003,21130,31.48,Non attribué
37,Indre-et-Loire,4,4ème circonscription,92132,23089,69043,4635,1595,62813,38442,24371,37004,37004,19807,32.29,Parti socialiste
37,Indre-et-Loire,5,5ème circonscription,86768,19878,66890,4292,1532,61066,36738,24328,37005,37005,19176,33.35,Parti communiste
38,Isère,1,1ère circonscription,85134,21186,63948,3661,842,59445,46992,12453,38001,38001,9558,16.39,Non attribué
38,Isère,2,2ème circonscription,78271,22875,55396,3847,978,50571,32520,18051,38002,38002,14840,29.07,Ecologistes
38,Isère,3,3ème circonscription,60057,19329,40728,2665,688,37375,26749,10626,38003,38003,9232,23.79,Non attribué
38,Isère,4,4ème circonscription,91620,22939,68681,5187,1250,62244,38551,23693,38004,38004,19600,32.02,Parti socialiste
38,Isère,5,5ème circonscription,105603,25136,80467,5733,1377,73357,46623,26734,38005,38005,21586,30.48,Ecologistes
38,Isère,6,6ème circonscription,88713,22539,66174,3805,985,61384,30143,31241,38006,38006,26223,46.25,Non attribué
38,Isère,7,7ème circonscription,95735,22701,73034,4796,1440,66798,32719,34079,38007,38007,28036,44.47,Parti communiste
38,Isère,8,8ème circonscription,82065,20802,61263,3860,1205,56198,30416,25782,38008,38008,21281,39.94,Ecologistes
38,Isère,9,9ème circonscription,100151,24951,75200,5572,1269,68359,40961,27398,38009,38009,22018,33.37,Non attribué
38,Isère,10,10ème circonscription,98323,26940,71383,4358,1322,65703,34011,31692,38010,38010,26723,42.38,Non attribué
39,Jura,1,1ère circonscription,64863,15167,49696,3890,1497,44309,23976,20333,39001,39001,16495,37.09,Non attribué
39,Jura,2,2ème circonscription,55597,13882,41715,3196,1056,37463,20826,16637,39002,39002,13798,37.03,Parti communiste
39,Jura,3,3ème circonscription,70183,16819,53364,3817,1594,47953,24041,23912,39003,39003,19595,41.32,Ecologistes
40,Landes,1,1ère circonscription,107990,25058,82932,6886,2213,73833,40491,33342,40001,40001,23115,33.43,Non attribué
40,Landes,2,2ème circonscription,122237,28197,94040,7611,2705,83724,50190,33534,40002,40002,21804,28.59,Parti communiste
40,Landes,3,3ème circonscription,99148,19864,79284,6233,2855,70196,38090,32106,40003,40003,21742,32.04,Parti socialiste
41,Loir-et-Cher,1,1ère circonscription,82551,21432,61119,4116,1486,55517,33008,22509,41001,41001,18779,34.09,Non attribué
41,Loir-et-Cher,2,2ème circonscription,80291,18933,61358,3639,1516,56203,27584,28619,41002,41002,24148,44.09,Parti communiste
41,Loir-et-Cher,3,3ème circonscription,81798,18048,63750,4124,1554,58072,30767,27305,41003,41003,22969,40.43,Ecologistes
42,Loire,1,1ère circonscription,64109,19962,44147,2754,933,40460,25781,14679,42001,42001,12711,29.87,Non attribué
42,Loire,2,2ème circonscription,50629,17471,33158,2146,690,30322,20748,9574,42002,42002,8589,25.6,Non attribué
42,Loire,3,3ème circonscription,83126,23153,59973,4276,771,54926,30648,24278,42003,42003,19972,36.8,Non attribué
42,Loire,4,4ème circonscription,103516,26965,76551,5342,1647,69562,36837,32725,42004,42004,27227,39.75,Non attribué
42,Loire,5,5ème circonscription,101890,24007,77883,5328,1845,70710,38344,32366,42005,42005,26566,38.2,Non attribué
42,Loire,6,6ème circonscription,110692,25312,85380,5536,1772,78072,42520,35552,42006,42006,28649,38.77,Non attribué
43,Haute-Loire,1,1ère circonscription,101370,22842,78528,5887,2268,70373,34832,35541,43001,43001,25769,38.36,Ecologistes
43,Haute-Loire,2,2ème circonscription,79346,18297,61049,4959,2112,53978,27540,26438,43002,43002,18343,34.5,Non attribué
44,Loire-Atlantique,1,1ère circonscription,76934,20313,56621,3943,698,51980,41332,10648,44001,44001,7357,14.26,Parti socialiste
44,Loire-Atlantique,2,2ème circonscription,90746,24852,65894,4479,1082,60333,49793,10540,44002,44002,7307,12.49,Non attribué
44,Loire-Atlantique,3,3ème circonscription,96336,27593,68743,5589,1077,62077,46078,15999,44003,44003,11698,19.06,Non attribué
44,Loire-Atlantique,4,4ème circonscription,92962,23885,69077,5274,1668,62135,46430,15705,44004,44004,11107,18.17,Ecologistes
44,Loire-Atlantique,5,5ème circonscription,125403,27540,97863,6717,1987,89159,64965,24194,44005,44005,16220,19.52,Non attribué
44,Loire-Atlantique,6,6ème circonscription,115027,27254,87773,6279,2339,79155,47866,31289,44006,44006,23801,31.21,Ecologistes
44,Loire-Atlantique,7,7ème circonscription,117003,25461,91542,6630,1870,83042,52052,30990,44007,44007,20183,28.17,Parti communiste
44,Loire-Atlantique,8,8ème circonscription,89718,24702,65016,5197,1629,58190,36711,21479,44008,44008,14182,27.41,Non attribué
44,Loire-Atlantique,9,9ème circonscription,129431,28811,100620,7080,2317,91223,56443,34780,44009,44009,25098,30.58,Non attribué
44,Loire-Atlantique,10,10ème circonscription,123363,24702,98661,6628,2209,89824,63510,26314,44010,44010,18400,22.14,Non attribué
45,Loiret,1,1ère circonscription,77330,19259,58071,3693,1121,53257,36574,16683,45001,45001,13261,25.4,Parti socialiste
45,Loiret,2,2ème circonscription,86583,22740,63843,3959,1395,58489,36057,22432,45002,45002,18877,32.95,Ecologistes
45,Loiret,3,3ème circonscription,70829,16694,54135,3297,1191,49647,25872,23775,45003,45003,20767,42.3,Non attribué
45,Loiret,4,4ème circonscription,74627,20253,54374,2922,1182,50270,24124,26146,45004,45004,23006,46.26,Parti communiste
45,Loiret,5,5ème circonscription,73358,18019,55339,3207,1074,51058,26012,25046,45005,45005,21966,43.66,Non attribué
45,Loiret,6,6ème circonscription,75036,18828,56208,3561,1155,51492,32243,19249,45006,45006,15858,31.66,Non attribué
46,Lot,1,1ère circonscription,72673,16727,55946,5056,2322,48568,28188,20380,46001,46001,14066,29.33,Non attribué
46,Lot,2,2ème circonscription,66565,14679,51886,4981,2312,44593,26942,17651,46002,46002,11736,26.21,Non attribué
47,Lot-et-Garonne,1,1ère circonscription,88171,21001,67170,4852,2108,60210,31859,28351,47001,47001,22926,38.32,Ecologistes
47,Lot-et-Garonne,2,2ème circonscription,77280,18287,58993,3964,2102,52927,24670,28257,47002,47002,22575,42.93,Parti socialiste
47,Lot-et-Garonne,3,3ème circonscription,75861,18818,57043,4086,1875,51082,24816,26266,47003,47003,20892,40.65,Non attribué
48,Lozère,1,1ère circonscription,59800,13098,46702,3950,2044,40708,22064,18644,48001,48001,13275,32.97,Non attribué
49,Maine-et-Loire,1,1ère circonscription,87675,22142,65533,4258,1308,59967,42999,16968,49001,49001,12830,22.31,Ecologistes
49,Maine-et-Loire,2,2ème circonscription,93668,22506,71162,4904,1684,64574,45695,18879,49002,49002,14072,22.53,Non attribué
49,Maine-et-Loire,3,3ème circonscription,72343,17009,55334,3368,1156,50810,27310,23500,49003,49003,19128,39.38,Parti communiste
49,Maine-et-Loire,4,4ème circonscription,76068,17081,58987,3537,1187,54263,32466,21797,49004,49004,18062,34.65,Non attribué
49,Maine-et-Loire,5,5ème circonscription,79313,19020,60293,3475,1294,55524,38901,16623,49005,49005,12236,22.76,Non attribué
49,Maine-et-Loire,6,6ème circonscription,98755,22282,76473,4827,1662,69984,47892,22092,49006,49006,17317,25.8,Non attribué
49,Maine-et-Loire,7,7ème circonscription,81646,18462,63184,3992,1245,57947,39547,18400,49007,49007,14136,25.68,Parti socialiste
50,Manche,1,1ère circonscription,87713,20061,67652,4084,1345,62223,36197,26026,50001,50001,20621,33.73,Non attribué
50,Manche,2,2ème circonscription,96984,21961,75023,4389,1749,68885,42715,26170,50002,50002,20812,31.01,Non attribué
50,Manche,3,3ème circonscription,110685,24903,85782,5558,1813,78411,45381,33030,50003,50003,26445,35.01,Non attribué
50,Manche,4,4ème circonscription,89280,24121,65159,5026,1543,58590,35522,23068,50004,50004,18248,30.93,Parti socialiste
51,Marne,1,1ère circonscription,73961,21064,52897,2762,996,49139,28658,20481,51001,51001,17300,36.58,Non attribué
51,Marne,2,2ème circonscription,74372,19984,54388,2789,1007,50592,30097,20495,51002,51002,17079,35.45,Non attribué
51,Marne,3,3ème circonscription,79971,21528,58443,3254,1003,54186,27093,27093,51003,51003,24416,45.97,Non attribué
51,Marne,4,4ème circonscription,76627,20114,56513,3008,1246,52259,26677,25582,51004,51004,22366,42.79,Non attribué
51,Marne,5,5ème circonscription,75837,16686,59151,3068,1133,54950,23528,31422,51005,51005,28066,52.75,Non attribué
52,Haute-Marne,1,1ère circonscription,69935,17188,52747,3252,1501,47994,22619,25375,52001,52001,21281,43.99,Non attribué
52,Haute-Marne,2,2ème circonscription,59462,15419,44043,2257,964,40822,15611,25211,52002,52002,23050,56.03,Non attribué
53,Mayenne,1,1ère circonscription,73609,17269,56340,3482,1376,51482,33730,17752,53001,53001,13332,26.35,Parti socialiste
53,Mayenne,2,2ème circonscription,78867,17439,61428,3599,1254,56575,37129,19446,53002,53002,14941,27.2,Ecologistes
53,Mayenne,3,3ème circonscription,72343,16327,56016,3360,1444,51212,31404,19808,53003,53003,15308,30.47,Non attribué
54,Meurthe-et-Moselle,1,1ère circonscription,81759,22644,59115,3781,1071,54263,36597,17666,54001,54001,14673,27.47,Non attribué
54,Meurthe-et-Moselle,2,2ème circonscription,67369,18598,48771,3116,861,44794,32149,12645,54002,54002,11038,23.92,Parti socialiste
54,Meurthe-et-Moselle,3,3ème circonscription,80563,25857,54706,3333,1236,50137,24680,25457,54003,54003,20458,40.14,Non attribué
54,Meurthe-et-Moselle,4,4ème circonscription,97329,24147,73182,4354,1543,67285,31500,35785,54004,54004,31512,47.55,Ecologistes
54,Meurthe-et-Moselle,5,5ème circonscription,78192,17816,60376,3469,1320,55587,27236,28351,54005,54005,25347,46.71,Parti socialiste
54,Meurthe-et-Moselle,6,6ème circonscription,87066,24237,62829,4180,1311,57338,27086,30252,54006,54006,25874,45.71,Non attribué
55,Meuse,1,1ère circonscription,75384,17592,57792,3241,1280,53271,23739,29532,55001,55001,25739,48.51,Parti socialiste
55,Meuse,2,2ème circonscription,59418,14883,44535,2382,964,41189,18194,22995,55002,55002,19528,48.21,Non attribué
56,Morbihan,1,1ère circonscription,114550,24852,89698,6195,1707,81796,57346,24450,56001,56001,16903,22.37,Parti socialiste
56,Morbihan,2,2ème circonscription,112055,23499,88556,6554,2131,79871,51229,28642,56002,56002,20321,27.87,Non attribué
56,Morbihan,3,3ème circonscription,96312,20113,76199,4737,2152,69310,40053,29257,56003,56003,21249,32.67,Non attribué
56,Morbihan,4,4ème circonscription,111310,23376,87934,6166,1869,79899,46582,33317,56004,56004,24981,33.34,Parti communiste
56,Morbihan,5,5ème circonscription,81604,22108,59496,4726,1229,53541,36443,17098,56005,56005,12666,23.64,Ecologistes
56,Morbihan,6,6ème circonscription,93485,21112,72373,5091,2227,65055,38102,26953,56006,56006,18956,30.26,Non attribué
57,Moselle,1,1ère circonscription,92626,27803,64823,3883,1014,59926,32771,27155,57001,57001,22815,38.48,Non attribué
57,Moselle,2,2ème circonscription,76128,21239,54889,3289,786,50814,30085,20729,57002,57002,17951,35.67,Non attribué
57,Moselle,3,3ème circonscription,75612,21805,53807,3282,889,49636,30152,19484,57003,57003,16611,33.98,Non attribué
57,Moselle,4,4ème circonscription,80878,18797,62081,3252,1024,57805,24643,33162,57004,57004,28539,50.78,Parti communiste
57,Moselle,5,5ème circonscription,72463,18913,53550,2675,986,49889,21670,28219,57005,57005,24291,48.94,Non attribué
57,Moselle,6,6ème circonscription,66756,21729,45027,2265,642,42120,18423,23697,57006,57006,21261,48.64,Non attribué
57,Moselle,7,7ème circonscription,89320,24105,65215,3522,1066,60627,25609,35018,57007,57007,29974,50.22,Ecologistes
57,Moselle,8,8ème circonscription,91080,31036,60044,3703,973,55368,26474,28894,57008,57008,23431,41.59,Non attribué
57,Moselle,9,9ème circonscription,101284,27455,73829,4198,1155,68476,39766,28710,57009,57009,22724,34.3,Parti socialiste
58,Nièvre,1,1ère circonscription,74520,21470,53050,4021,1365,47664,24796,22868,58001,58001,18899,38.49,Non attribué
58,Nièvre,2,2ème circonscription,79720,19620,60100,4072,2071,53957,25902,28055,58002,58002,23047,41.47,Non attribué
59,Nord,1,1ère circonscription,63583,21018,42565,2409,875,39281,29279,10002,59001,59001,9151,23.67,Non attribué
59,Nord,2,2ème circonscription,86310,27045,59265,3675,1319,54271,38248,16023,59002,59002,15391,27.34,Non attribué
59,Nord,3,3ème circonscription,92286,29414,62872,2992,1285,58595,23663,34932,59003,59003,31984,53.81,Non attribué
59,Nord,4,4ème circonscription,100902,26243,74659,3697,1354,69608,48127,21481,59004,59004,18870,28.21,Ecologistes
59,Nord,5,5ème circonscription,101274,24144,77130,4371,1475,71284,39335,31949,59005,59005,28718,42.14,Non attribué
59,Nord,6,6ème circonscription,93472,19337,74135,3948,1357,68830,42462,26368,59006,59006,22328,35.25,Non attribué
59,Nord,7,7ème circonscription,73391,22196,51195,2742,1008,47445,31186,16259,59007,59007,14748,31.11,Ecologistes
59,Nord,8,8ème circonscription,68207,28948,39259,2043,808,36408,21575,14833,59008,59008,14413,36.22,Non attribué
59,Nord,9,9ème circonscription,91981,27228,64753,3158,1121,60474,44580,15894,59009,59009,13681,23.08,Ecologistes
59,Nord,10,10ème circonscription,82061,28141,53920,2625,964,50331,28791,21540,59010,59010,20309,40.34,Non attribué
59,Nord,11,11ème circonscription,93915,28591,65324,3513,1486,60325,37625,22700,59011,59011,20496,34.58,Parti socialiste
59,Nord,12,12ème circonscription,92892,24539,68353,3441,1491,63421,24868,38553,59012,59012,34181,55.66,Non attribué
59,Nord,13,13ème circonscription,87039,27042,59997,3705,1307,54985,25405,29580,59013,59013,28185,49.98,Non attribué
59,Nord,14,14ème circonscription,99249,22809,76440,3839,1648,70953,32631,38322,59014,59014,34301,50.05,Non attribué
59,Nord,15,15ème circonscription,97759,22476,75283,3652,1692,69939,34145,35794,59015,59015,30879,46.4,Ecologistes
59,Nord,16,16ème circonscription,83630,23982,59648,3157,1287,55204,20667,34537,59016,59016,30012,56.51,Parti communiste
59,Nord,17,17ème circonscription,73487,20911,52576,2815,1169,48592,21599,26993,59017,59017,23737,49.76,Non attribué
59,Nord,18,18ème circonscription,90914,24345,66569,3107,1382,62080,24228,37852,59018,59018,33190,55.18,Non attribué
59,Nord,19,19ème circonscription,80141,23431,56710,2822,1195,52693,19308,33385,59019,59019,29769,58.33,Parti communiste
59,Nord,20,20ème circonscription,81424,25211,56213,2730,1155,52328,20912,31416,59020,59020,28578,56.02,Parti communiste
59,Nord,21,21ème circonscription,80829,24078,56751,2893,1091,52767,25417,27350,59021,59021,24513,46.72,Non attribué
60,Oise,1,1ère circonscription,83024,20601,62423,3288,1393,57742,24934,32808,60001,60001,29118,51.03,Parti communiste
60,Oise,2,2ème circonscription,88777,20884,67893,3607,1289,62997,26658,36339,60002,60002,32061,52.09,Non attribué
60,Oise,3,3ème circonscription,73635,22426,51209,3083,1165,46961,23194,23767,60003,60003,21123,43.79,Non attribué
60,Oise,4,4ème circonscription,93352,23018,70334,3873,1227,65234,35259,29975,60004,60004,25198,40.21,Non attribué
60,Oise,5,5ème circonscription,73163,18810,54353,3201,1112,50040,24441,25599,60005,60005,22207,45.22,Ecologistes
60,Oise,6,6ème circonscription,75644,18439,57205,3286,1048,52871,24786,28085,60006,60006,23858,46.88,Parti socialiste
60,Oise,7,7ème circonscription,76589,20952,55637,3575,1251,50811,23519,27292,60007,60007,23984,47.44,Parti communiste
61,Orne,1,1ère circonscription,68435,16481,51954,3168,1118,47668,28125,19543,61001,61001,16613,34.52,Parti socialiste
61,Orne,2,2ème circonscription,66027,15408,50619,2921,1034,46664,23424,23240,61002,61002,20447,44.13,Ecologistes
61,Orne,3,3ème circonscription,71091,16869,54222,3448,1280,49494,27726,21768,61003,61003,18010,36.69,Non attribué
62,Pas-de-Calais,1,1ère circonscription,104878,21339,83539,3933,1821,77785,32094,45691,62001,62001,40031,53.75,Non attribué
62,Pas-de-Calais,2,2ème circonscription,86912,20432,66480,3655,1872,60953,34011,26942,62002,62002,22416,38.3,Non attribué
62,Pas-de-Calais,3,3ème circonscription,83141,25696,57445,2627,1314,53504,19544,33960,62003,62003,31526,58.65,Parti communiste
62,Pas-de-Calais,4,4ème circonscription,89784,19702,70082,3110,1560,65412,33610,31802,62004,62004,26851,42.84,Parti socialiste
62,Pas-de-Calais,5,5ème circonscription,90510,24408,66102,3432,1444,61226,29577,31649,62005,62005,27419,46.14,Non attribué
62,Pas-de-Calais,6,6ème circonscription,93562,18335,75227,3409,1933,69885,29554,40331,62006,62006,34315,51.91,Non attribué
62,Pas-de-Calais,7,7ème circonscription,93881,26447,67434,3189,1696,62549,25162,37387,62007,62007,33570,55.17,Ecologistes
62,Pas-de-Calais,8,8ème circonscription,92057,22311,69746,3261,1899,64586,27909,36677,62008,62008,32125,50.67,Non attribué
62,Pas-de-Calais,9,9ème circonscription,80008,19122,60886,2904,1474,56508,25915,30593,62009,62009,26164,48.47,Non attribué
62,Pas-de-Calais,10,10ème circonscription,88878,23309,65569,2718,1421,61430,20851,40579,62010,62010,34950,59.79,Non attribué
62,Pas-de-Calais,11,11ème circonscription,93974,27077,66897,2860,1549,62488,22866,39622,62011,62011,35585,58.17,Ecologistes
62,Pas-de-Calais,12,12ème circonscription,96254,25565,70689,3048,1519,66122,22922,43200,62012,62012,37830,60.52,Parti socialiste
63,Puy-de-Dôme,1,1ère circonscription,83741,25017,58724,4272,1500,52952,35080,17872,63001,63001,12938,24.0,Non attribué
63,Puy-de-Dôme,2,2ème circonscription,89850,20506,69344,5547,2360,61437,34068,27369,63002,63002,19123,32.31,Parti socialiste
63,Puy-de-Dôme,3,3ème circonscription,89541,21646,67895,5275,1876,60744,41499,19245,63003,63003,13161,21.84,Non attribué
63,Puy-de-Dôme,4,4ème circonscription,100918,24253,76665,6268,2443,67954,40571,27383,63004,63004,18718,28.34,Non attribué
63,Puy-de-Dôme,5,5ème circonscription,104096,25072,79024,6091,2727,70206,37250,32956,63005,63005,24215,35.52,Parti communiste
64,Pyrénées-Atlantiques,1,1ère circonscription,68672,16828,51844,4223,1400,46221,30271,15950,64001,64001,11113,23.85,Non attribué
64,Pyrénées-Atlantiques,2,2ème circonscription,82787,18068,64719,5226,1885,57608,36067,21541,64002,64002,14569,25.96,Ecologistes
64,Pyrénées-Atlantiques,3,3ème circonscription,83785,19472,64313,5498,2357,56458,32428,24030,64003,64003,16282,29.01,Non attribué
64,Pyrénées-Atlantiques,4,4ème circonscription,80665,18590,62075,6627,2498,52950,31820,21130,64004,64004,13687,25.56,Parti socialiste
64,Pyrénées-Atlantiques,5,5ème circonscription,98915,25150,73765,6127,1912,65726,42530,23196,64005,64005,14787,24.24,Non attribué
64,Pyrénées-Atlantiques,6,6ème circonscription,105130,26745,78385,6679,2124,69582,46650,22932,64006,64006,14939,22.78,Non attribué
65,Hautes-Pyrénées,1,1ère circonscription,87905,22028,65877,6248,2618,57011,31927,25084,65001,65001,17500,30.32,Non attribué
65,Hautes-Pyrénées,2,2ème circonscription,89539,21395,68144,5342,2546,60256,33158,27098,65002,65002,19725,33.26,Non attribué
66,Pyrénées-Orientales,1,1ère circonscription,72319,20369,51950,3034,1280,47636,22972,24664,66001,66001,19828,43.72,Non attribué
66,Pyrénées-Orientales,2,2ème circonscription,103348,26173,77175,4365,1957,70853,27900,42953,66002,66002,33582,52.25,Ecologistes
66,Pyrénées-Orientales,3,3ème circonscription,84781,22851,61930,4541,1993,55396,25333,30063,66003,66003,22581,44.26,Non attribué
66,Pyrénées-Orientales,4,4ème circonscription,101676,25167,76509,5078,2206,69225,29983,39242,66004,66004,29883,46.78,Non attribué
67,Bas-Rhin,1,1ère circonscription,61529,18534,42995,2239,644,40112,32370,7742,67001,67001,6558,15.65,Ecologistes
67,Bas-Rhin,2,2ème circonscription,71570,21295,50275,2798,708,46769,34147,12622,67002,67002,10885,23.48,Non attribué
67,Bas-Rhin,3,3ème circonscription,70047,21263,48784,2580,712,45492,32080,13412,67003,67003,11655,25.72,Non attribué
67,Bas-Rhin,4,4ème circonscription,97296,22682,74614,3566,1132,69916,44660,25256,67004,67004,21483,32.5,Non attribué
67,Bas-Rhin,5,5ème circonscription,105940,25289,80651,4205,1300,75146,40340,34806,67005,67005,30222,42.49,Non attribué
67,Bas-Rhin,6,6ème circonscription,97351,22549,74802,3806,1269,69727,37601,32126,67006,67006,27696,42.05,Ecologistes
67,Bas-Rhin,7,7ème circonscription,85674,20006,65668,3452,1168,61048,29686,31362,67007,67007,27499,46.57,Non attribué
67,Bas-Rhin,8,8ème circonscription,94482,22598,71884,3178,1145,67561,32433,35128,67008,67008,31113,47.46,Non attribué
67,Bas-Rhin,9,9ème circonscription,95105,23468,71637,3313,1059,67265,36881,30384,67009,67009,26677,42.05,Non attribué
68,Haut-Rhin,1,1ère circonscription,77987,21537,56450,3004,961,52485,28509,23976,68001,68001,20264,39.72,Parti socialiste
68,Haut-Rhin,2,2ème circonscription,92482,21882,70600,3988,1248,65364,35352,30012,68002,68002,26064,41.25,Non attribué
68,Haut-Rhin,3,3ème circonscription,86857,21427,65430,3440,1041,60949,31698,29251,68003,68003,25248,43.6,Non attribué
68,Haut-Rhin,4,4ème circonscription,103839,25246,78593,4251,1403,72939,33183,39756,68004,68004,34165,49.24,Non attribué
68,Haut-Rhin,5,5ème circonscription,76741,23646,53095,3675,381,49039,30437,18602,68005,68005,16196,32.76,Ecologistes
68,Haut-Rhin,6,6ème circonscription,94012,27523,66489,3812,862,61815,32635,29180,68006,68006,25662,42.57,Non attribué
69,Rhône,1,1ère circonscription,71509,18744,52765,2979,898,48888,37725,11163,69001,69001,8809,18.7,Non attribué
69,Rhône,2,2ème circonscription,72002,16704,55298,3185,838,51275,42044,9231,69002,69002,7038,13.51,Ecologistes
69,Rhône,3,3ème circonscription,71727,18291,53436,3090,792,49554,39946,9608,69003,69003,7811,15.71,Ecologistes
69,Rhône,4,4ème circonscription,77564,17113,60451,3104,886,56461,44820,11641,69004,69004,8845,15.91,Ecologistes
69,Rhône,5,5ème circonscription,89622,21041,68581,3569,938,64074,45959,18115,69005,69005,14197,23.64,Parti socialiste
69,Rhône,6,6ème circonscription,88520,30848,57672,3611,923,53138,40375,12763,69006,69006,10758,20.5,Non attribué
69,Rhône,7,7ème circonscription,70485,26469,44016,2588,874,40554,27948,12606,69007,69007,11051,26.65,Non attribué
69,Rhône,8,8ème circonscription,104552,23700,80852,4744,1377,74731,45585,29146,69008,69008,23253,33.12,Parti communiste
69,Rhône,9,9ème circonscription,96009,23642,72367,4273,1141,66953,38911,28042,69009,69009,23655,37.72,Non attribué
69,Rhône,10,10ème circonscription,98894,21313,77581,4342,1183,72056,46631,25425,69010,69010,19930,29.56,Parti socialiste
69,Rhône,11,11ème circonscription,96107,23838,72269,4374,1256,66639,39004,27635,69011,69011,22471,35.88,Parti communiste
69,Rhône,12,12ème circonscription,81666,19908,61758,3388,917,57453,40726,16727,69012,69012,12999,23.74,Ecologistes
69,Rhône,13,13ème circonscription,88196,24427,63769,3284,995,59490,35197,24293,69013,69013,20768,36.47,Non attribué
69,Rhône,14,14ème circonscription,74938,29180,45758,2781,979,41998,26673,15325,69014,69014,13732,31.11,Non attribué
70,Haute-Saône,1,1ère circonscription,88123,19660,68463,4314,2169,61980,27901,34079,70001,70001,28369,46.46,Non attribué
70,Haute-Saône,2,2ème circonscription,89601,20869,68732,4019,2405,62308,25667,36641,70002,70002,30972,50.1,Non attribué
71,Saône-et-Loire,1,1ère circonscription,74171,18842,55329,4075,1070,50184,30458,19726,71001,71001,15947,32.44,Ecologistes
71,Saône-et-Loire,2,2ème circonscription,77064,18274,58790,4093,1638,53059,27776,25283,71002,71002,20467,38.52,Parti communiste
71,Saône-et-Loire,3,3ème circonscription,81160,20104,61056,4217,1716,55123,28710,26413,71003,71003,22145,39.92,Non attribué
71,Saône-et-Loire,4,4ème circonscription,82776,20272,62504,4215,1518,56771,26974,29797,71004,71004,24170,43.65,Parti socialiste
71,Saône-et-Loire,5,5ème circonscription,87825,24823,63002,4530,1760,56712,31071,25641,71005,71005,21196,36.71,Non attribué
72,Sarthe,1,1ère circonscription,73076,17646,55430,4218,756,50456,30710,19746,72001,72001,15363,31.76,Non attribué
72,Sarthe,2,2ème circonscription,83012,22991,60021,5009,895,54117,30866,23251,72002,72002,18767,35.25,Parti socialiste
72,Sarthe,3,3ème circonscription,86460,21056,65404,4173,1638,59593,29396,30197,72003,72003,24225,42.43,Non attribué
72,Sarthe,4,4ème circonscription,80879,19937,60942,4290,1238,55414,30503,24911,72004,72004,18855,36.3,Parti socialiste
72,Sarthe,5,5ème circonscription,87844,21969,65875,4644,1244,59987,33434,26553,72005,72005,21313,36.73,Non attribué
73,Savoie,1,1ère circonscription,92966,22160,70806,4676,1491,64639,37548,27091,73001,73001,21197,35.56,Parti communiste
73,Savoie,2,2ème circonscription,76055,19795,56260,4099,1145,51016,27962,23054,73002,73002,18388,37.14,Non attribué
73,Savoie,3,3ème circonscription,74219,17612,56607,4171,1353,51083,27406,23677,73003,73003,19171,38.77,Non attribué
73,Savoie,4,4ème circonscription,77490,20401,57089,4293,1277,51519,32854,18665,73004,73004,14842,29.6,Non attribué
74,Haute-Savoie,1,1ère circonscription,108261,25255,83006,5022,1550,76434,49353,27081,74001,74001,20648,29.16,Non attribué
74,Haute-Savoie,2,2ème circonscription,99768,24776,74992,4791,1249,68952,45562,23390,74002,74002,17890,27.28,Parti communiste
74,Haute-Savoie,3,3ème circonscription,87661,21552,66109,4236,1225,60648,33982,26666,74003,74003,20564,36.54,Non attribué
74,Haute-Savoie,4,4ème circonscription,87896,26076,61820,3669,950,57201,35625,21576,74004,74004,17006,30.53,Non attribué
74,Haute-Savoie,5,5ème circonscription,101173,27077,74096,4820,1353,67923,40613,27310,74005,74005,20518,32.33,Ecologistes
74,Haute-Savoie,6,6ème circonscription,81079,22448,58631,3549,1040,54042,32371,21671,74006,74006,17120,33.49,Non attribué
75,Paris,1,1ère circonscription,97845,22300,75545,3182,834,71529,59970,11559,75001,75001,5607,9.19,Non attribué
75,Paris,2,2ème circonscription,74596,16087,58509,2368,734,55407,47316,8091,75002,75002,5572,10.33,Parti socialiste
75,Paris,3,3ème circonscription,71247,18276,52971,2502,700,49769,42871,6898,75003,75003,5072,10.14,Ecologistes
75,Paris,4,4ème circonscription,74053,18036,56017,2148,578,53291,44402,8889,75004,75004,5898,11.66,Non attribué
75,Paris,5,5ème circonscription,78791,19383,59408,2474,707,56227,50321,5906,75005,75005,4127,7.23,Ecologistes
75,Paris,6,6ème circonscription,80342,21775,58567,3093,854,54620,48415,6205,75006,75006,4387,7.87,Non attribué
75,Paris,7,7ème circonscription,79577,18396,61181,2603,799,57779,51284,6495,75007,75007,4535,7.86,Non attribué
75,Paris,8,8ème circonscription,83884,22477,61407,3507,1023,56877,47743,9134,75008,75008,6792,11.45,Ecologistes
75,Paris,9,9ème circonscription,70367,19684,50683,3119,987,46577,38302,8275,75009,75009,6001,12.33,Ecologistes
75,Paris,10,10ème circonscription,69843,19180,50663,2982,855,46826,38607,8219,75010,75010,5967,12.39,Non attribué
75,Paris,11,11ème circonscription,72863,16288,56575,2730,750,53095,45892,7203,75011,75011,4953,9.23,Parti socialiste
75,Paris,12,12ème circonscription,76542,17343,59199,2659,714,55826,46118,9708,75012,75012,6656,12.17,Parti communiste
75,Paris,13,13ème circonscription,77857,19323,58534,2845,844,54845,44885,9960,75013,75013,6998,12.86,Ecologistes
75,Paris,14,14ème circonscription,75794,17762,58032,2287,677,55068,45014,10054,75014,75014,6668,12.85,Non attribué
75,Paris,15,15ème circonscription,78675,23817,54858,3265,910,50683,43237,7446,75015,75015,5596,10.53,Non attribué
75,Paris,16,16ème circonscription,74530,24576,49954,2814,844,46296,39834,6462,75016,75016,4657,9.58,Non attribué
75,Paris,17,17ème circonscription,61714,22159,39555,2367,665,36523,31197,5326,75017,75017,4057,10.4,Non attribué
75,Paris,18,18ème circonscription,70103,17627,52476,2465,647,49364,43600,5764,75018,75018,4227,8.57,Non attribué
76,Seine-Maritime,1,1ère circonscription,65910,18562,47348,3030,834,43484,32899,10585,76001,76001,8723,20.15,Non attribué
76,Seine-Maritime,2,2ème circonscription,95031,19262,75769,4582,1339,69848,43377,26471,76002,76002,22433,33.7,Non attribué
76,Seine-Maritime,3,3ème circonscription,69748,22616,47132,3852,1154,42126,26254,15872,76003,76003,14291,32.26,Parti communiste
76,Seine-Maritime,4,4ème circonscription,86825,25529,61296,4220,1491,55585,29727,25858,76004,76004,22399,39.49,Non attribué
76,Seine-Maritime,5,5ème circonscription,94948,21072,73876,4798,1480,67598,34326,33272,76005,76005,28536,43.56,Parti socialiste
76,Seine-Maritime,6,6ème circonscription,109775,25102,84673,4749,1660,78264,35605,42659,76006,76006,37343,49.59,Parti communiste
76,Seine-Maritime,7,7ème circonscription,86475,23761,62714,5242,435,57037,36766,20271,76007,76007,17551,31.3,Non attribué
76,Seine-Maritime,8,8ème circonscription,65418,23495,41923,3981,244,37698,21065,16633,76008,76008,15241,39.51,Parti communiste
76,Seine-Maritime,9,9ème circonscription,95442,21243,74199,4582,1661,67956,32582,35374,76009,76009,30105,46.65,Non attribué
76,Seine-Maritime,10,10ème circonscription,110084,22098,87986,5080,1675,81231,39538,41693,76010,76010,36235,46.8,Ecologistes
77,Seine-et-Marne,1,1ère circonscription,70771,23104,47667,3138,915,43614,26295,17319,77001,77001,14444,32.4,Non attribué
77,Seine-et-Marne,2,2ème circonscription,79608,20891,58717,3872,1072,53773,30928,22845,77002,77002,18906,35.72,Non attribué
77,Seine-et-Marne,3,3ème circonscription,76953,22078,54875,3937,1142,49796,25748,24048,77003,77003,20586,40.93,Non attribué
77,Seine-et-Marne,4,4ème circonscription,88502,23335,65167,4058,1283,59826,26053,33773,77004,77004,29607,50.4,Non attribué
77,Seine-et-Marne,5,5ème circonscription,87803,24694,63109,3929,1179,58001,30413,27588,77005,77005,23329,41.39,Non attribué
77,Seine-et-Marne,6,6ème circonscription,81219,25158,56061,3951,971,51139,25835,25304,77006,77006,21490,41.88,Non attribué
77,Seine-et-Marne,7,7ème circonscription,87185,25540,61645,4071,1114,56460,32075,24385,77007,77007,21041,37.4,Non attribué
77,Seine-et-Marne,8,8ème circonscription,94632,27530,67102,4313,1131,61658,40867,20791,77008,77008,15936,26.66,Ecologistes
77,Seine-et-Marne,9,9ème circonscription,85906,25495,60411,3971,1059,55381,32430,22951,77009,77009,18940,34.04,Non attribué
77,Seine-et-Marne,10,10ème circonscription,81092,26647,54445,3840,1132,49473,34227,15246,77010,77010,12760,24.86,Non attribué
77,Seine-et-Marne,11,11ème circonscription,66138,22047,44091,3815,615,39661,24831,14830,77011,77011,12182,29.18,Parti socialiste
78,Yvelines,1,1ère circonscription,83310,21050,62260,3810,981,57469,42197,15272,78001,78001,11240,19.4,Non attribué
78,Yvelines,2,2ème circonscription,85961,19310,66651,3645,1060,61946,45615,16331,78002,78002,12463,20.35,Ecologistes
78,Yvelines,3,3ème circonscription,83294,19703,63591,3380,836,59375,43890,15485,78003,78003,10967,18.83,Non attribué
78,Yvelines,4,4ème circonscription,79895,19292,60603,3015,856,56732,43852,12880,78004,78004,9344,16.7,Non attribué
78,Yvelines,5,5ème circonscription,75347,20032,55315,2902,805,51608,39231,12377,78005,78005,9249,18.29,Non attribué
78,Yvelines,6,6ème circonscription,75628,20419,55209,2880,820,51509,38600,12909,78006,78006,9876,19.34,Non attribué
78,Yvelines,7,7ème circonscription,80308,23292,57016,3475,948,52593,36707,15886,78007,78007,13964,25.76,Parti socialiste
78,Yvelines,8,8ème circonscription,74223,25684,48539,3064,1005,44470,27797,16673,78008,78008,15345,32.57,Ecologistes
78,Yvelines,9,9ème circonscription,92693,25595,67098,4170,1239,61689,37349,24340,78009,78009,20680,33.62,Non attribué
78,Yvelines,10,10ème circonscription,91238,21336,69902,4365,1150,64387,43139,21248,78010,78010,16169,25.79,Non attribué
78,Yvelines,11,11ème circonscription,68860,20888,47972,3059,888,44025,31541,12484,78011,78011,9361,20.91,Non attribué
78,Yvelines,12,12ème circonscription,70871,18333,52538,3169,788,48581,34992,13589,78012,78012,10480,22.06,Ecologistes
79,Deux-Sèvres,1,1ère circonscription,90487,21645,68842,4803,1899,62140,42609,19531,79001,79001,14192,22.63,Non attribué
79,Deux-Sèvres,2,2ème circonscription,98023,22953,75070,5100,2125,67845,39857,27988,79002,79002,21221,31.2,Ecologistes
79,Deux-Sèvres,3,3ème circonscription,84754,19883,64871,3678,1582,59611,35339,24272,79003,79003,18626,31.5,Non attribué
80,Somme,1,1ère circonscription,83865,23621,60244,3305,1522,55417,28744,26673,80001,80001,23783,42.46,Non attribué
80,Somme,2,2ème circonscription,77409,20994,56415,3294,1158,51963,34678,17285,80002,80002,14639,28.56,Non attribué
80,Somme,3,3ème circonscription,82565,17256,65309,3560,1626,60123,26056,34067,80003,80003,30498,51.67,Non attribué
80,Somme,4,4ème circonscription,84906,17932,66974,3805,1398,61771,28756,33015,80004,80004,29351,49.08,Non attribué
80,Somme,5,5ème circonscription,81201,18684,62517,3030,1226,58261,22632,35629,80005,80005,31194,55.02,Non attribué
81,Tarn,1,1ère circonscription,84943,20784,64159,4666,2367,57126,31159,25967,81001,81001,20009,35.07,Non attribué
81,Tarn,2,2ème circonscription,109399,26907,82492,6621,3304,72567,38582,33985,81002,81002,25319,35.48,Ecologistes
81,Tarn,3,3ème circonscription,103838,23798,80040,5889,2635,71516,37027,34489,81003,81003,26528,38.43,Non attribué
82,Tarn-et-Garonne,1,1ère circonscription,92734,22264,70470,5247,2181,63042,32351,30691,82001,82001,23963,39.13,Parti socialiste
82,Tarn-et-Garonne,2,2ème circonscription,95994,21543,74451,4903,2317,67231,30152,37079,82002,82002,29203,45.69,Non attribué
83,Var,1,1ère circonscription,71869,21584,50285,3120,828,46337,23986,22351,83001,83001,19715,42.72,Non attribué
83,Var,2,2ème circonscription,91822,25383,66439,3817,1129,61493,27654,33839,83002,83002,28854,48.88,Non attribué
83,Var,3,3ème circonscription,103740,25489,78251,4456,1490,72305,35206,37099,83003,83003,31437,46.72,Parti socialiste
83,Var,4,4ème circonscription,112055,29483,82572,4058,1419,77095,33056,44039,83004,83004,36437,51.68,Non attribué
83,Var,5,5ème circonscription,101210,25548,75662,3560,1383,70719,31709,39010,83005,83005,32161,49.82,Non attribué
83,Var,6,6ème circonscription,126948,30785,96163,5299,1755,89109,36680,52429,83006,83006,41435,51.98,Parti communiste
83,Var,7,7ème circonscription,104729,29192,75537,4328,1156,70053,33121,36932,83007,83007,31354,46.99,Ecologistes
83,Var,8,8ème circonscription,108768,26757,82011,4705,1560,75746,31308,44438,83008,83008,36376,51.57,Non attribué
84,Vaucluse,1,1ère circonscription,73400,24341,49059,3168,1030,44861,26043,18818,84001,84001,17452,37.2,Non attribué
84,Vaucluse,2,2ème circonscription,85624,20700,64924,3816,1392,59716,28945,30771,84002,84002,26596,46.31,Non attribué
84,Vaucluse,3,3ème circonscription,78487,19232,59255,3358,1271,54626,23172,31454,84003,84003,27320,52.94,Parti communiste
84,Vaucluse,4,4ème circonscription,90092,21612,68480,4018,1281,63181,27849,35332,84004,84004,31180,50.94,Non attribué
84,Vaucluse,5,5ème circonscription,84124,20904,63220,4080,1344,57796,28466,29330,84005,84005,24565,43.92,Ecologistes
85,Vendée,1,1ère circonscription,118203,26018,92185,5071,2236,84878,53866,31012,85001,85001,22074,28.34,Ecologistes
85,Vendée,2,2ème circonscription,111825,24385,87440,5307,2164,79969,48600,31369,85002,85002,22229,30.31,Non attribué
85,Vendée,3,3ème circonscription,134914,31241,103673,5863,2411,95399,56978,38421,85003,85003,28096,33.85,Non attribué
85,Vendée,4,4ème circonscription,102358,20189,82169,4738,1694,75737,52269,23468,85004,85004,16936,23.65,Parti communiste
85,Vendée,5,5ème circonscription,83909,18880,65029,4067,1679,59283,32781,26502,85005,85005,19700,34.51,Non attribué
86,Vienne,1,1ère circonscription,80230,20238,59992,4330,1560,54102,35413,18689,86001,86001,14404,26.54,Non attribué
86,Vienne,2,2ème circonscription,79070,19261,59809,4303,1447,54059,37602,16457,86002,86002,12096,22.44,Non attribué
86,Vienne,3,3ème circonscription,72874,16966,55908,3773,1670,50465,26965,23500,86003,86003,18370,36.17,Non attribué
86,Vienne,4,4ème circonscription,73902,19687,54215,3232,1385,49598,25194,24404,86004,86004,20385,40.77,Parti socialiste
87,Haute-Vienne,1,1ère circonscription,84076,21736,62340,5120,2770,54450,32967,21483,87001,87001,15558,27.73,Non attribué
87,Haute-Vienne,2,2ème circonscription,97833,22161,75672,6126,3415,66131,38286,27845,87002,87002,19733,29.77,Parti socialiste
87,Haute-Vienne,3,3ème circonscription,81868,20550,61318,4638,2669,54011,32076,21935,87003,87003,16472,29.52,Non attribué
88,Vosges,1,1ère circonscription,76587,19940,56647,3245,1251,52151,27044,25107,88001,88001,21484,41.33,Non attribué
88,Vosges,2,2ème circonscription,72337,17805,54532,3108,1322,50102,21673,28429,88002,88002,24052,48.72,Non attribué
88,Vosges,3,3ème circonscription,63772,15271,48501,3245,1274,43982,22730,21252,88003,88003,18339,40.86,Ecologistes
88,Vosges,4,4ème circonscription,65229,14769,50460,2994,1306,46160,20095,26065,88004,88004,22019,48.14,Non attribué
89,Yonne,1,1ère circonscription,75020,18441,56579,3813,1228,51538,27445,24093,89001,89001,20597,40.0,Ecologistes
89,Yonne,2,2ème circonscription,73396,18307,55089,3456,1317,50316,23986,26330,89002,89002,23431,45.88,Non attribué
89,Yonne,3,3ème circonscription,89553,24977,64576,3830,1393,59353,26607,32746,89003,89003,28623,48.5,Non attribué
90,Territoire de Belfort,1,1ère circonscription,47405,12657,34748,2176,955,31617,15743,15874,90001,90001,13790,43.82,Non attribué
90,Territoire de Belfort,2,2ème circonscription,46343,12364,33979,2366,1041,30572,16244,14328,90002,90002,12338,39.8,Non attribué
91,Essonne,1,1ère circonscription,71929,27623,44306,3066,1024,40216,26740,13476,91001,91001,11070,25.24,Non attribué
91,Essonne,2,2ème circonscription,91553,24326,67227,4360,1308,61559,33016,28543,91002,91002,23690,39.14,Non attribué
91,Essonne,3,3ème circonscription,98309,25613,72696,5165,1540,65991,39831,26160,91003,91003,21080,32.39,Non attribué
91,Essonne,4,4ème circonscription,98272,24759,73513,4729,1358,67426,43923,23503,91004,91004,18855,28.12,Parti communiste
91,Essonne,5,5ème circonscription,68199,16276,51923,2907,787,48229,38343,9886,91005,91005,7251,14.81,Ecologistes
91,Essonne,6,6ème circonscription,82770,23292,59478,3598,1176,54704,39975,14729,91006,91006,11736,21.17,Parti socialiste
91,Essonne,7,7ème circonscription,73044,23525,49519,3316,1014,45189,29477,15712,91007,91007,13608,28.51,Non attribué
91,Essonne,8,8ème circonscription,75816,23646,52170,3580,1082,47508,31328,16180,91008,91008,14475,28.76,Non attribué
91,Essonne,9,9ème circonscription,78437,23629,54808,3688,1113,50007,32320,17687,91009,91009,14882,28.44,Ecologistes
91,Essonne,10,10ème circonscription,61531,21334,40197,2609,940,36648,23616,13032,91010,91010,10862,27.94,Non attribué
92,Hauts-de-Seine,1,1ère circonscription,65254,24923,40331,3422,503,36406,28280,8126,92001,92001,6949,17.88,Parti communiste
92,Hauts-de-Seine,2,2ème circonscription,69164,16935,52229,3118,542,48569,40144,8425,92002,92002,6302,13.02,Ecologistes
92,Hauts-de-Seine,3,3ème circonscription,82233,20160,62073,3883,348,57842,46591,11251,92003,92003,7903,13.86,Non attribué
92,Hauts-de-Seine,4,4ème circonscription,80026,25311,54715,3887,575,50253,39720,10533,92004,92004,8215,15.88,Ecologistes
92,Hauts-de-Seine,5,5ème circonscription,75251,20274,54977,3028,816,51133,41643,9490,92005,92005,6915,13.79,Non attribué
92,Hauts-de-Seine,6,6ème circonscription,75677,16489,59188,2928,751,55509,44374,11135,92006,92006,7642,14.06,Non attribué
92,Hauts-de-Seine,7,7ème circonscription,87626,20631,66995,3416,746,62833,50185,12648,92007,92007,9046,14.58,Non attribué
92,Hauts-de-Seine,8,8ème circonscription,67817,14863,52954,3125,431,49398,39982,9416,92008,92008,6907,13.87,Non attribué
92,Hauts-de-Seine,9,9ème circonscription,63137,13692,49445,3068,0,46377,38624,7753,92009,92009,5224,11.19,Ecologistes
92,Hauts-de-Seine,10,10ème circonscription,79169,19034,60135,4218,307,55610,45506,10104,92010,92010,7040,12.61,Parti socialiste
92,Hauts-de-Seine,11,11ème circonscription,70216,19769,50447,3221,975,46251,37166,9085,92011,92011,7010,14.69,Non attribué
92,Hauts-de-Seine,12,12ème circonscription,92978,23345,69633,4062,1188,64383,49605,14778,92012,92012,11178,17.29,Non attribué
92,Hauts-de-Seine,13,13ème circonscription,89643,22121,67522,4990,287,62245,50304,11941,92013,92013,8701,13.86,Parti socialiste
93,Seine-Saint-Denis,1,1ère circonscription,66519,26232,40287,2656,792,36839,29361,7478,93001,93001,5729,15.82,Non attribué
93,Seine-Saint-Denis,2,2ème circonscription,54696,24437,30259,2225,616,27418,21134,6284,93002,93002,5334,17.43,Parti communiste
93,Seine-Saint-Denis,3,3ème circonscription,75075,23676,51399,3530,920,46949,33420,13529,93003,93003,10909,22.72,Non attribué
93,Seine-Saint-Denis,4,4ème circonscription,64803,28991,35812,2917,525,32370,22846,9524,93004,93004,8185,22.88,Parti communiste
93,Seine-Saint-Denis,5,5ème circonscription,64590,27362,37228,2607,758,33863,23276,10587,93005,93005,9179,24.75,Non attribué
93,Seine-Saint-Denis,6,6ème circonscription,57437,23120,34317,2308,708,31301,25245,6056,93006,93006,5046,15.87,Non attribué
93,Seine-Saint-Denis,7,7ème circonscription,79866,27937,51929,4057,771,47101,38932,8169,93007,93007,6525,13.85,Non attribué
93,Seine-Saint-Denis,8,8ème circonscription,61193,20770,40423,3284,547,36592,25264,11328,93008,93008,9718,25.08,Parti socialiste
93,Seine-Saint-Denis,9,9ème circonscription,73260,26387,46873,3237,954,42682,33372,9310,93009,93009,7828,17.84,Non attribué
93,Seine-Saint-Denis,10,10ème circonscription,68941,27811,41130,2974,808,37348,26444,10904,93010,93010,9300,23.02,Non attribué
93,Seine-Saint-Denis,11,11ème circonscription,63017,26869,36148,2565,802,32781,22772,10009,93011,93011,9163,24.73,Non attribué
93,Seine-Saint-Denis,12,12ème circonscription,64967,24579,40388,2277,1077,37034,23987,13047,93012,93012,11909,29.77,Non attribué
94,Val-de-Marne,1,1ère circonscription,84446,22933,61513,3642,1057,56814,42964,13850,94001,94001,10753,18.47,Non attribué
94,Val-de-Marne,2,2ème circonscription,65155,23259,41896,3075,915,37906,27823,10083,94002,94002,8186,19.75,Non attribué
94,Val-de-Marne,3,3ème circonscription,73378,24083,49295,3489,968,44838,28897,15941,94003,94003,13378,28.93,Non attribué
94,Val-de-Marne,4,4ème circonscription,73450,20784,52666,3381,954,48331,33002,15329,94004,94004,12310,25.12,Non attribué
94,Val-de-Marne,5,5ème circonscription,89882,27732,62150,3787,910,57453,43297,14156,94005,94005,10920,18.64,Parti communiste
94,Val-de-Marne,6,6ème circonscription,81773,21536,60237,3323,957,55957,46053,9904,94006,94006,7399,12.91,Ecologistes
94,Val-de-Marne,7,7ème circonscription,65988,21521,44467,3127,810,40530,29744,10786,94007,94007,8715,20.41,Non attribué
94,Val-de-Marne,8,8ème circonscription,78042,20799,57243,3638,1082,52523,39844,12679,94008,94008,9910,18.62,Non attribué
94,Val-de-Marne,9,9ème circonscription,53643,18570,35073,2493,748,31832,23220,8612,94009,94009,7140,21.23,Parti socialiste
94,Val-de-Marne,10,10ème circonscription,66544,22881,43663,3043,1012,39608,30688,8920,94010,94010,7225,17.32,Non attribué
94,Val-de-Marne,11,11ème circonscription,64481,21383,43098,3109,704,39285,30672,8613,94011,94011,6737,16.95,Ecologistes
95,Val-d'Oise,1,1ère circonscription,82149,22525,59624,4006,1142,54476,31937,22539,95001,95001,19358,35.28,Non attribué
95,Val-d'Oise,2,2ème circonscription,77882,22904,54978,3570,1114,50294,31745,18549,95002,95002,15412,30.44,Non attribué
95,Val-d'Oise,3,3ème circonscription,94006,27524,66482,4313,1220,60949,40261,20688,95003,95003,16993,28.01,Non attribué
95,Val-d'Oise,4,4ème circonscription,75244,22643,52601,3524,901,48176,33676,14500,95004,95004,12132,24.43,Non attribué
95,Val-d'Oise,5,5ème circonscription,68696,26078,42618,2735,831,39052,28410,10642,95005,95005,9876,23.09,Non attribué
95,Val-d'Oise,6,6ème circonscription,75030,23998,51032,3260,792,46980,33943,13037,95006,95006,10800,21.89,Non attribué
95,Val-d'Oise,7,7ème circonscription,68940,23013,45927,2936,823,42168,27839,14329,95007,95007,11482,25.55,Non attribué
95,Val-d'Oise,8,8ème circonscription,54159,22791,31368,1949,637,28782,19288,9494,95008,95008,8104,24.98,Non attribué
95,Val-d'Oise,9,9ème circonscription,70184,25012,45172,2958,984,41230,23789,17441,95009,95009,15340,35.48,Non attribué
95,Val-d'Oise,10,10ème circonscription,67586,22490,45096,3234,694,41168,28941,12227,95010,95010,10021,23.32,Non attribué
ZA,Guadeloupe,1,1ère circonscription,75952,41915,34037,2025,2058,29954,8311,21643,ZA001,ZA001,7675,23.94,Non attribué
ZA,Guadeloupe,2,2ème circonscription,87594,45855,41739,2273,2104,37362,11509,25853,ZA002,ZA002,9773,26.55,Non attribué
ZA,Guadeloupe,3,3ème circonscription,84232,42833,41399,2549,2120,36730,11675,25055,ZA003,ZA003,8744,24.11,Non attribué
ZA,Guadeloupe,4,4ème circonscription,68163,36281,31882,1664,1929,28289,8734,19555,ZA004,ZA004,7118,24.7,Non attribué
ZB,Martinique,1,1ère circonscription,80071,42786,37285,2998,1971,32316,11899,20417,ZB001,ZB001,8771,24.93,Non attribué
ZB,Martinique,2,2ème circonscription,80285,42503,37782,2863,1934,32985,13252,19733,ZB002,ZB002,8603,23.02,Non attribué
ZB,Martinique,3,3ème circonscription,60299,33822,26477,2522,1364,22591,9533,13058,ZB003,ZB003,5474,20.28,Non attribué
ZB,Martinique,4,4ème circonscription,84015,47090,36925,2815,2084,32026,12234,19792,ZB004,ZB004,7347,21.02,Non attribué
ZC,Guyane,1,1ère circonscription,56674,31539,25135,2037,748,22350,8486,13864,ZC001,ZC001,7374,36.11,Non attribué
ZC,Guyane,2,2ème circonscription,46384,31431,14953,1027,469,13457,5587,7870,ZC002,ZC002,4403,33.55,Non attribué
ZD,La Réunion,1,1ère circonscription,85325,34817,50508,2706,1533,46269,23493,22776,ZD001,ZD001,15129,33.11,Non attribué
ZD,La Réunion,2,2ème circonscription,98787,42347,56440,3173,2596,50671,22760,27911,ZD002,ZD002,16530,33.76,Non attribué
ZD,La Réunion,3,3ème circonscription,96081,35687,60394,3008,2516,54870,17593,37277,ZD003,ZD003,25858,50.29,Non attribué
ZD,La Réunion,4,4ème circonscription,108569,40289,68280,3635,3217,61428,23790,37638,ZD004,ZD004,23960,40.27,Non attribué
ZD,La Réunion,5,5ème circonscription,87536,37039,50497,1928,1986,46583,16217,30366,ZD005,ZD005,19592,44.59,Non attribué
ZD,La Réunion,6,6ème circonscription,81795,34566,47229,2147,1650,43432,16913,26519,ZD006,ZD006,17406,42.58,Non attribué
ZD,La Réunion,7,7ème circonscription,117965,49777,68188,3888,3262,61038,26504,34534,ZD007,ZD007,21442,34.8,Non attribué
ZM,Mayotte,1,1ère circonscription,42650,23914,18736,802,927,17007,7709,9298,ZM001,ZM001,5856,37.52,Non attribué
ZM,Mayotte,2,2ème circonscription,49771,26466,23305,793,1118,21394,7998,13396,ZM002,ZM002,8518,47.57,Non attribué
ZN,Nouvelle-Calédonie,1,1ère circonscription,96748,61032,35716,1418,504,33794,21575,12219,ZN001,ZN001,18271,46.84,Non attribué
ZN,Nouvelle-Calédonie,2,2ème circonscription,121965,81559,40406,1612,833,37961,22220,15741,ZN002,ZN002,24946,47.87,Non attribué
ZP,Polynésie française,1,1ère circonscription,71945,37980,33965,890,626,32449,18269,14180,ZP001,ZP001,14452,42.85,Non attribué
ZP,Polynésie française,2,2ème circonscription,67056,40776,26280,650,568,25062,12348,12714,ZP002,ZP002,11737,41.37,Non attribué
ZP,Polynésie française,3,3ème circonscription,66632,39958,26674,858,524,25292,12273,13019,ZP003,ZP003,11130,40.33,Non attribué
ZS,Saint-Pierre-et-Miquelon,1,Saint-Pierre-et-Miquelon,5043,2164,2879,219,139,2521,1243,1278,ZS001,ZS001,851,36.71,Non attribué
ZW,Wallis et Futuna,1,1ère circonscription,9514,3674,5840,82,79,5679,3830,1849,ZW001,ZW001,1243,20.86,Non attribué
ZX,Saint-Martin/Saint-Barthélemy,1,1ère circonscription,24435,15107,9328,471,220,8637,3850,4787,ZX001,ZX001,2840,34.97,Non attribué
ZZ,Français établis hors de France,1,1ère circonscription,237737,151044,86693,2104,470,84119,74491,9628,ZZ001,ZZ001,7603,8.92,Non attribué
ZZ,Français établis hors de France,2,2ème circonscription,75335,55527,19808,628,194,18986,16163,2823,ZZ002,ZZ002,2679,10.7,Non attribué
ZZ,Français établis hors de France,3,3ème circonscription,138527,78832,59695,1205,270,58220,53859,4361,ZZ003,ZZ003,3185,5.27,Non attribué
ZZ,Français établis hors de France,4,4ème circonscription,146813,72886,73927,2041,464,71422,61963,9459,ZZ004,ZZ004,6678,10.43,Non attribué
ZZ,Français établis hors de France,5,5ème circonscription,104039,65688,38351,1151,267,36933,29404,7529,ZZ005,ZZ005,5232,15.1,Non attribué
ZZ,Français établis hors de France,6,6ème circonscription,148705,80964,67741,1950,380,65411,54032,11379,ZZ006,ZZ006,9275,14.49,Non attribué
ZZ,Français établis hors de France,7,7ème circonscription,122145,62433,59712,1257,299,58156,53169,4987,ZZ007,ZZ007,3558,6.3,Non attribué
ZZ,Français établis hors de France,8,8ème circonscription,130068,105245,24823,775,188,23860,20515,3345,ZZ008,ZZ008,3143,10.16,Non attribué
ZZ,Français établis hors de France,9,9ème circonscription,121013,81608,39405,1497,342,37566,32578,4988,ZZ009,ZZ009,3690,8.68,Non attribué
ZZ,Français établis hors de France,10,10ème circonscription,104829,63530,41299,1326,325,39648,31563,8085,ZZ010,ZZ010,8535,18.71,Non attribué
ZZ,Français établis hors de France,11,11ème circonscription,98707,58675,40032,1358,291,38383,31137,7246,ZZ011,ZZ011,5837,12.49,Non attribué
